aberalaw	TheCitadel.txt
accept	PrideAndPrejudice.txt	
accident	TheCitadel.txt	
afraid	CrimeAndPunishment.txt	PrideAndPrejudice.txt	TheCitadel.txt	TheWarOfTheWorlds.txt
afternoon	TheCitadel.txt	BraveNewWorld.txt
air	TheWarOfTheWorlds.txt	BraveNewWorld.txt	
album	Misery.txt
alive	TheWarOfTheWorlds.txt	
annie	Misery.txt	
anxious	PrideAndPrejudice.txt	
appear	PrideAndPrejudice.txt	
appearance	CrimeAndPunishment.txt	PrideAndPrejudice.txt	
appeared	TheWarOfTheWorlds.txt	PrideAndPrejudice.txt	
area	TheCitadel.txt	
ask	TheCitadel.txt	CrimeAndPunishment.txt	TheKingOfTorts.txt	Misery.txt	PrideAndPrejudice.txt	
asked	BraveNewWorld.txt	TheWarOfTheWorlds.txt	TheCitadel.txt	CrimeAndPunishment.txt	PrideAndPrejudice.txt	TheKingOfTorts.txt	Misery.txt
astonishment	PrideAndPrejudice.txt
attention	PrideAndPrejudice.txt	
attorney	TheKingOfTorts.txt
bad	TheCitadel.txt	PrideAndPrejudice.txt	BraveNewWorld.txt	Misery.txt	TheKingOfTorts.txt	
bag	TheCitadel.txt	
beat	CrimeAndPunishment.txt	
beating	CrimeAndPunishment.txt	BraveNewWorld.txt	
beautiful	PrideAndPrejudice.txt	BraveNewWorld.txt	
behaviour	PrideAndPrejudice.txt
believed	PrideAndPrejudice.txt	
bennet	PrideAndPrejudice.txt
bennets	PrideAndPrejudice.txt
bernards	BraveNewWorld.txt
best	Misery.txt	PrideAndPrejudice.txt	TheCitadel.txt	
blank	Misery.txt	
board	TheCitadel.txt
bodies	TheWarOfTheWorlds.txt	
body	CrimeAndPunishment.txt	BraveNewWorld.txt	Misery.txt	TheWarOfTheWorlds.txt
boland	TheCitadel.txt
book	BraveNewWorld.txt	Misery.txt	
boon	TheCitadel.txt
boys	BraveNewWorld.txt	
breath	TheCitadel.txt	
bridge	TheWarOfTheWorlds.txt	
brought	PrideAndPrejudice.txt	Misery.txt	CrimeAndPunishment.txt	TheCitadel.txt	
building	TheCitadel.txt	
business	TheKingOfTorts.txt	CrimeAndPunishment.txt	PrideAndPrejudice.txt	
busy	TheCitadel.txt	TheWarOfTheWorlds.txt	
came	PrideAndPrejudice.txt	TheCitadel.txt	TheWarOfTheWorlds.txt	CrimeAndPunishment.txt	BraveNewWorld.txt	Misery.txt
car	Misery.txt	TheCitadel.txt	
case	CrimeAndPunishment.txt	PrideAndPrejudice.txt	TheKingOfTorts.txt	TheCitadel.txt
catherine	PrideAndPrejudice.txt
caught	TheWarOfTheWorlds.txt	BraveNewWorld.txt
cause	PrideAndPrejudice.txt	TheCitadel.txt	
cellar	Misery.txt
cement	TheKingOfTorts.txt
certainly	PrideAndPrejudice.txt	TheWarOfTheWorlds.txt	
changed	TheCitadel.txt	
charge	TheCitadel.txt	
chest	CrimeAndPunishment.txt	
christine	TheCitadel.txt
civilized	BraveNewWorld.txt
client	TheKingOfTorts.txt
climbed	BraveNewWorld.txt	
cloth	Misery.txt
cloud	TheWarOfTheWorlds.txt	
coal	TheCitadel.txt
cold	TheCitadel.txt	PrideAndPrejudice.txt	
collins	PrideAndPrejudice.txt
company	TheKingOfTorts.txt	
confusion	PrideAndPrejudice.txt	
copecks	CrimeAndPunishment.txt
course	CrimeAndPunishment.txt	Misery.txt	TheCitadel.txt	BraveNewWorld.txt	PrideAndPrejudice.txt	TheKingOfTorts.txt
cousin	PrideAndPrejudice.txt
crazy	Misery.txt	
crittle	TheKingOfTorts.txt
dark	TheWarOfTheWorlds.txt	BraveNewWorld.txt	Misery.txt	CrimeAndPunishment.txt	
darkness	TheWarOfTheWorlds.txt	
daughter	PrideAndPrejudice.txt	CrimeAndPunishment.txt	
days	TheCitadel.txt	BraveNewWorld.txt	PrideAndPrejudice.txt	TheWarOfTheWorlds.txt	Misery.txt	TheKingOfTorts.txt	CrimeAndPunishment.txt
dc	TheKingOfTorts.txt
deal	CrimeAndPunishment.txt
dear	CrimeAndPunishment.txt	TheCitadel.txt	PrideAndPrejudice.txt	
dennys	TheCitadel.txt
destroyed	TheWarOfTheWorlds.txt	
died	Misery.txt	
different	Misery.txt	CrimeAndPunishment.txt	BraveNewWorld.txt	
difficult	TheCitadel.txt	
direction	TheWarOfTheWorlds.txt	
dirty	Misery.txt	TheCitadel.txt	
distance	TheWarOfTheWorlds.txt	
doctor	TheKingOfTorts.txt	TheCitadel.txt	
does	CrimeAndPunishment.txt	PrideAndPrejudice.txt	
doing	CrimeAndPunishment.txt	PrideAndPrejudice.txt	TheKingOfTorts.txt	TheCitadel.txt
dollars	TheKingOfTorts.txt	
door	BraveNewWorld.txt	Misery.txt	CrimeAndPunishment.txt	PrideAndPrejudice.txt	TheKingOfTorts.txt	TheWarOfTheWorlds.txt	TheCitadel.txt
dr	TheCitadel.txt
drineffy	TheCitadel.txt
drove	TheCitadel.txt	
dust	TheCitadel.txt	
duty	PrideAndPrejudice.txt	
early	TheWarOfTheWorlds.txt	PrideAndPrejudice.txt	TheCitadel.txt
earth	TheWarOfTheWorlds.txt	
effect	PrideAndPrejudice.txt	
elizabeth	PrideAndPrejudice.txt
enormous	TheWarOfTheWorlds.txt
entered	BraveNewWorld.txt	PrideAndPrejudice.txt	TheCitadel.txt
evans	TheCitadel.txt
everybody	TheKingOfTorts.txt	
examine	TheCitadel.txt	
explained	TheCitadel.txt	
faces	BraveNewWorld.txt
fair	TheCitadel.txt	
family	TheKingOfTorts.txt	PrideAndPrejudice.txt	CrimeAndPunishment.txt
far	CrimeAndPunishment.txt	TheWarOfTheWorlds.txt	
fast	Misery.txt	
favourite	PrideAndPrejudice.txt	
feel	BraveNewWorld.txt	TheCitadel.txt	Misery.txt	PrideAndPrejudice.txt	CrimeAndPunishment.txt
felt	CrimeAndPunishment.txt	TheCitadel.txt	BraveNewWorld.txt	TheKingOfTorts.txt	PrideAndPrejudice.txt	TheWarOfTheWorlds.txt	Misery.txt
fighting	TheWarOfTheWorlds.txt
filled	BraveNewWorld.txt	
film	BraveNewWorld.txt	
fine	TheKingOfTorts.txt	PrideAndPrejudice.txt	
finished	Misery.txt	TheCitadel.txt	TheKingOfTorts.txt
firm	TheKingOfTorts.txt	
fitzwilliam	PrideAndPrejudice.txt
flash	TheWarOfTheWorlds.txt	
flowers	BraveNewWorld.txt	
followed	PrideAndPrejudice.txt	TheCitadel.txt
following	TheCitadel.txt	PrideAndPrejudice.txt	
food	Misery.txt	TheWarOfTheWorlds.txt	TheCitadel.txt	
forced	PrideAndPrejudice.txt	
ford	BraveNewWorld.txt
forwards	TheWarOfTheWorlds.txt	
free	BraveNewWorld.txt	
french	TheKingOfTorts.txt
gardiner	PrideAndPrejudice.txt
gentlemen	PrideAndPrejudice.txt	
gill	TheCitadel.txt
girl	TheCitadel.txt	CrimeAndPunishment.txt	BraveNewWorld.txt
glass	Misery.txt	
goffman	TheKingOfTorts.txt
going	TheKingOfTorts.txt	BraveNewWorld.txt	PrideAndPrejudice.txt	TheCitadel.txt	CrimeAndPunishment.txt	Misery.txt	TheWarOfTheWorlds.txt
government	TheKingOfTorts.txt	
grateful	PrideAndPrejudice.txt	
green	BraveNewWorld.txt	
grey	TheWarOfTheWorlds.txt	
griffiths	TheCitadel.txt
guns	TheWarOfTheWorlds.txt	
hands	TheWarOfTheWorlds.txt	Misery.txt	CrimeAndPunishment.txt	BraveNewWorld.txt	TheCitadel.txt
happened	TheWarOfTheWorlds.txt	CrimeAndPunishment.txt	Misery.txt	PrideAndPrejudice.txt	
hard	Misery.txt	TheKingOfTorts.txt	
hay	CrimeAndPunishment.txt
heart	CrimeAndPunishment.txt	PrideAndPrejudice.txt	TheCitadel.txt
heavy	CrimeAndPunishment.txt	
helmholtz	BraveNewWorld.txt
henry	BraveNewWorld.txt
herself	Misery.txt	CrimeAndPunishment.txt	BraveNewWorld.txt	TheCitadel.txt	PrideAndPrejudice.txt
hit	TheWarOfTheWorlds.txt	
hole	TheWarOfTheWorlds.txt	Misery.txt
honoured	CrimeAndPunishment.txt	
hopper	TheCitadel.txt
horn	TheKingOfTorts.txt	
horrible	BraveNewWorld.txt
hot	BraveNewWorld.txt	TheCitadel.txt	
houses	TheWarOfTheWorlds.txt	
hurt	Misery.txt	
id	Misery.txt	TheKingOfTorts.txt
idea	TheCitadel.txt	TheWarOfTheWorlds.txt	PrideAndPrejudice.txt	
im	Misery.txt	TheCitadel.txt	TheKingOfTorts.txt	BraveNewWorld.txt
immediately	TheKingOfTorts.txt	TheCitadel.txt	TheWarOfTheWorlds.txt	PrideAndPrejudice.txt
inside	BraveNewWorld.txt	TheCitadel.txt	Misery.txt	TheWarOfTheWorlds.txt
instant	CrimeAndPunishment.txt
intended	PrideAndPrejudice.txt	
interrupted	TheCitadel.txt	
invitation	PrideAndPrejudice.txt	
joined	PrideAndPrejudice.txt
just	TheKingOfTorts.txt	TheWarOfTheWorlds.txt	Misery.txt	BraveNewWorld.txt	TheCitadel.txt	CrimeAndPunishment.txt	PrideAndPrejudice.txt
katerina	CrimeAndPunishment.txt
kept	Misery.txt	CrimeAndPunishment.txt	BraveNewWorld.txt	TheKingOfTorts.txt	TheCitadel.txt
kitty	PrideAndPrejudice.txt
labs	TheKingOfTorts.txt
large	TheCitadel.txt	BraveNewWorld.txt	TheWarOfTheWorlds.txt	TheKingOfTorts.txt	PrideAndPrejudice.txt	
lawrence	TheCitadel.txt
lawsuit	TheKingOfTorts.txt
lawyer	TheKingOfTorts.txt	
left	TheKingOfTorts.txt	CrimeAndPunishment.txt	Misery.txt	PrideAndPrejudice.txt	BraveNewWorld.txt	TheWarOfTheWorlds.txt	TheCitadel.txt
legs	Misery.txt	
let	Misery.txt	CrimeAndPunishment.txt	TheCitadel.txt	PrideAndPrejudice.txt	BraveNewWorld.txt	
lighthouse	BraveNewWorld.txt
like	BraveNewWorld.txt	TheCitadel.txt	PrideAndPrejudice.txt	CrimeAndPunishment.txt	TheKingOfTorts.txt	TheWarOfTheWorlds.txt	Misery.txt
linda	BraveNewWorld.txt
line	TheWarOfTheWorlds.txt	
little	CrimeAndPunishment.txt	TheCitadel.txt	PrideAndPrejudice.txt	Misery.txt	BraveNewWorld.txt	TheWarOfTheWorlds.txt	TheKingOfTorts.txt
lizaveta	CrimeAndPunishment.txt
llewellyn	TheCitadel.txt
longbourn	PrideAndPrejudice.txt
loud	BraveNewWorld.txt	
lower	BraveNewWorld.txt	
lunch	TheCitadel.txt	
lying	TheWarOfTheWorlds.txt	BraveNewWorld.txt
machine	BraveNewWorld.txt	TheWarOfTheWorlds.txt
man	PrideAndPrejudice.txt	TheKingOfTorts.txt	Misery.txt	TheCitadel.txt	BraveNewWorld.txt	CrimeAndPunishment.txt	TheWarOfTheWorlds.txt
manager	TheCitadel.txt
mare	CrimeAndPunishment.txt
married	PrideAndPrejudice.txt
martians	TheWarOfTheWorlds.txt
mass	TheKingOfTorts.txt	
maxatil	TheKingOfTorts.txt
maybe	TheKingOfTorts.txt	CrimeAndPunishment.txt	Misery.txt
meal	TheCitadel.txt	
means	PrideAndPrejudice.txt	
medical	TheCitadel.txt	
medicines	TheCitadel.txt	
meet	PrideAndPrejudice.txt	TheKingOfTorts.txt	TheCitadel.txt	
meryton	PrideAndPrejudice.txt
mind	Misery.txt	PrideAndPrejudice.txt	CrimeAndPunishment.txt	BraveNewWorld.txt	TheWarOfTheWorlds.txt	TheCitadel.txt
miners	TheCitadel.txt
minutes	PrideAndPrejudice.txt	TheCitadel.txt	Misery.txt	TheKingOfTorts.txt	BraveNewWorld.txt	
mond	BraveNewWorld.txt
month	CrimeAndPunishment.txt	TheCitadel.txt	
mothers	PrideAndPrejudice.txt	
movement	TheWarOfTheWorlds.txt
mr	CrimeAndPunishment.txt	TheKingOfTorts.txt	TheCitadel.txt	PrideAndPrejudice.txt	BraveNewWorld.txt
mustapha	BraveNewWorld.txt
nastasya	CrimeAndPunishment.txt
nearly	TheCitadel.txt	Misery.txt	
need	TheKingOfTorts.txt	TheCitadel.txt	BraveNewWorld.txt	
news	PrideAndPrejudice.txt	TheCitadel.txt	TheWarOfTheWorlds.txt	TheKingOfTorts.txt	
newspapers	TheKingOfTorts.txt	
nice	TheCitadel.txt	
night	CrimeAndPunishment.txt	BraveNewWorld.txt	TheKingOfTorts.txt	TheWarOfTheWorlds.txt	TheCitadel.txt	PrideAndPrejudice.txt	
notice	Misery.txt	PrideAndPrejudice.txt	TheCitadel.txt	
novril	Misery.txt
ogilvy	TheWarOfTheWorlds.txt
old	BraveNewWorld.txt	Misery.txt	TheCitadel.txt	TheKingOfTorts.txt	CrimeAndPunishment.txt
oldest	PrideAndPrejudice.txt
pace	TheKingOfTorts.txt	
pain	BraveNewWorld.txt	Misery.txt
pale	BraveNewWorld.txt	
papers	TheKingOfTorts.txt	TheWarOfTheWorlds.txt	
park	TheWarOfTheWorlds.txt	
pass	CrimeAndPunishment.txt	
patient	TheCitadel.txt
paused	TheCitadel.txt	
people	CrimeAndPunishment.txt	Misery.txt	PrideAndPrejudice.txt	TheKingOfTorts.txt	TheWarOfTheWorlds.txt	BraveNewWorld.txt	TheCitadel.txt
perfectly	PrideAndPrejudice.txt	
person	PrideAndPrejudice.txt	
petrovitch	CrimeAndPunishment.txt
phone	Misery.txt	TheKingOfTorts.txt
picked	Misery.txt
place	CrimeAndPunishment.txt	TheCitadel.txt	PrideAndPrejudice.txt	TheWarOfTheWorlds.txt	BraveNewWorld.txt	Misery.txt
plan	TheKingOfTorts.txt
pleasant	PrideAndPrejudice.txt	
pleasure	PrideAndPrejudice.txt	
police	Misery.txt	TheKingOfTorts.txt	
politeness	PrideAndPrejudice.txt
poor	BraveNewWorld.txt	CrimeAndPunishment.txt	TheCitadel.txt	PrideAndPrejudice.txt	
pope	BraveNewWorld.txt
position	PrideAndPrejudice.txt	
post	TheCitadel.txt	
present	PrideAndPrejudice.txt	TheCitadel.txt	
pride	PrideAndPrejudice.txt
profession	TheCitadel.txt	
pumpkin	TheKingOfTorts.txt
pyotr	CrimeAndPunishment.txt
question	CrimeAndPunishment.txt	Misery.txt	TheCitadel.txt	
quick	TheKingOfTorts.txt	
rang	TheCitadel.txt	
rats	Misery.txt
read	CrimeAndPunishment.txt	PrideAndPrejudice.txt	TheKingOfTorts.txt	BraveNewWorld.txt	Misery.txt	TheCitadel.txt	
reason	BraveNewWorld.txt	CrimeAndPunishment.txt	PrideAndPrejudice.txt	TheCitadel.txt
refused	PrideAndPrejudice.txt	TheCitadel.txt
remarked	TheCitadel.txt	
replied	TheKingOfTorts.txt	TheCitadel.txt	PrideAndPrejudice.txt
reply	PrideAndPrejudice.txt	
reservation	BraveNewWorld.txt
return	TheCitadel.txt	PrideAndPrejudice.txt	Misery.txt
rodney	TheKingOfTorts.txt
rolled	Misery.txt	
room	TheWarOfTheWorlds.txt	TheKingOfTorts.txt	TheCitadel.txt	PrideAndPrejudice.txt	BraveNewWorld.txt	CrimeAndPunishment.txt	Misery.txt
rushed	BraveNewWorld.txt	
safe	TheWarOfTheWorlds.txt	
sat	TheKingOfTorts.txt	CrimeAndPunishment.txt	TheCitadel.txt	BraveNewWorld.txt	TheWarOfTheWorlds.txt	PrideAndPrejudice.txt
saw	TheCitadel.txt	BraveNewWorld.txt	CrimeAndPunishment.txt	PrideAndPrejudice.txt	TheKingOfTorts.txt	TheWarOfTheWorlds.txt	Misery.txt
saying	Misery.txt	TheCitadel.txt	BraveNewWorld.txt	PrideAndPrejudice.txt	TheKingOfTorts.txt
sea	TheWarOfTheWorlds.txt	
second	TheKingOfTorts.txt	TheWarOfTheWorlds.txt	TheCitadel.txt	
seen	Misery.txt	CrimeAndPunishment.txt	PrideAndPrejudice.txt	BraveNewWorld.txt	TheKingOfTorts.txt	TheCitadel.txt	TheWarOfTheWorlds.txt
sent	BraveNewWorld.txt	TheWarOfTheWorlds.txt	TheCitadel.txt
servant	PrideAndPrejudice.txt
settle	TheKingOfTorts.txt	
shaking	CrimeAndPunishment.txt	
shall	BraveNewWorld.txt	PrideAndPrejudice.txt	TheCitadel.txt	CrimeAndPunishment.txt
shame	PrideAndPrejudice.txt	
shop	TheCitadel.txt
sign	TheKingOfTorts.txt	BraveNewWorld.txt	
similar	TheKingOfTorts.txt	
sir	CrimeAndPunishment.txt	PrideAndPrejudice.txt	TheCitadel.txt	
sister	CrimeAndPunishment.txt	PrideAndPrejudice.txt
sky	TheWarOfTheWorlds.txt	BraveNewWorld.txt	
smile	TheKingOfTorts.txt	PrideAndPrejudice.txt	TheCitadel.txt	Misery.txt	BraveNewWorld.txt
snakes	BraveNewWorld.txt
society	BraveNewWorld.txt	
sonia	CrimeAndPunishment.txt
sound	Misery.txt	BraveNewWorld.txt	TheWarOfTheWorlds.txt
speak	TheCitadel.txt	PrideAndPrejudice.txt
square	BraveNewWorld.txt	
staff	TheKingOfTorts.txt
started	TheWarOfTheWorlds.txt	TheKingOfTorts.txt	Misery.txt	
steam	TheWarOfTheWorlds.txt
steps	CrimeAndPunishment.txt	
stillmans	TheCitadel.txt
stood	TheKingOfTorts.txt	TheWarOfTheWorlds.txt	BraveNewWorld.txt	Misery.txt	CrimeAndPunishment.txt	TheCitadel.txt
stop	TheCitadel.txt	TheKingOfTorts.txt	Misery.txt
story	Misery.txt	TheKingOfTorts.txt	
strange	BraveNewWorld.txt	TheWarOfTheWorlds.txt	CrimeAndPunishment.txt	TheCitadel.txt	
street	CrimeAndPunishment.txt	TheKingOfTorts.txt	TheWarOfTheWorlds.txt	TheCitadel.txt
strong	BraveNewWorld.txt	PrideAndPrejudice.txt	
suggested	TheCitadel.txt	
sunday	TheWarOfTheWorlds.txt	TheCitadel.txt	
suppose	TheCitadel.txt	BraveNewWorld.txt	PrideAndPrejudice.txt	Misery.txt
table	TheCitadel.txt	CrimeAndPunishment.txt	PrideAndPrejudice.txt	Misery.txt	TheKingOfTorts.txt	
taking	CrimeAndPunishment.txt	BraveNewWorld.txt	TheKingOfTorts.txt	
talked	TheKingOfTorts.txt	TheCitadel.txt	PrideAndPrejudice.txt	
talking	BraveNewWorld.txt	CrimeAndPunishment.txt	TheKingOfTorts.txt	TheCitadel.txt	PrideAndPrejudice.txt	
talmadge	TheKingOfTorts.txt
tavern	CrimeAndPunishment.txt
tell	TheKingOfTorts.txt	BraveNewWorld.txt	Misery.txt	CrimeAndPunishment.txt	TheCitadel.txt	PrideAndPrejudice.txt
thing	Misery.txt	TheWarOfTheWorlds.txt	CrimeAndPunishment.txt	TheCitadel.txt	TheKingOfTorts.txt
things	TheKingOfTorts.txt	BraveNewWorld.txt	Misery.txt	TheWarOfTheWorlds.txt	TheCitadel.txt	CrimeAndPunishment.txt
thousand	PrideAndPrejudice.txt	BraveNewWorld.txt	TheKingOfTorts.txt	
took	Misery.txt	TheWarOfTheWorlds.txt	CrimeAndPunishment.txt	BraveNewWorld.txt	PrideAndPrejudice.txt	TheKingOfTorts.txt	TheCitadel.txt
tort	TheKingOfTorts.txt
treatment	TheCitadel.txt	
trees	TheWarOfTheWorlds.txt	
turn	Misery.txt	BraveNewWorld.txt	
twins	BraveNewWorld.txt
ulla	TheWarOfTheWorlds.txt
uncle	PrideAndPrejudice.txt
understand	PrideAndPrejudice.txt	TheCitadel.txt	BraveNewWorld.txt	CrimeAndPunishment.txt	
unhappy	BraveNewWorld.txt	
unpleasant	BraveNewWorld.txt	
urquhart	TheCitadel.txt
used	TheCitadel.txt	BraveNewWorld.txt	CrimeAndPunishment.txt	TheWarOfTheWorlds.txt	TheKingOfTorts.txt	
van	TheKingOfTorts.txt
vaughan	TheCitadel.txt
victoria	TheCitadel.txt	
visit	TheCitadel.txt	PrideAndPrejudice.txt
walked	BraveNewWorld.txt	TheWarOfTheWorlds.txt	PrideAndPrejudice.txt	CrimeAndPunishment.txt	TheCitadel.txt	TheKingOfTorts.txt
want	PrideAndPrejudice.txt	CrimeAndPunishment.txt	BraveNewWorld.txt	TheKingOfTorts.txt	Misery.txt	TheCitadel.txt
warm	TheCitadel.txt	
watched	TheWarOfTheWorlds.txt
water	TheWarOfTheWorlds.txt	TheCitadel.txt	Misery.txt	BraveNewWorld.txt	
watson	BraveNewWorld.txt	TheKingOfTorts.txt
way	Misery.txt	BraveNewWorld.txt	PrideAndPrejudice.txt	TheKingOfTorts.txt	TheWarOfTheWorlds.txt	CrimeAndPunishment.txt	TheCitadel.txt
welcome	PrideAndPrejudice.txt	
weve	TheCitadel.txt
wickhams	PrideAndPrejudice.txt
wife	TheCitadel.txt	CrimeAndPunishment.txt	TheWarOfTheWorlds.txt	PrideAndPrejudice.txt
william	PrideAndPrejudice.txt
wished	PrideAndPrejudice.txt	
wishes	PrideAndPrejudice.txt	
women	TheKingOfTorts.txt	BraveNewWorld.txt	
words	Misery.txt	CrimeAndPunishment.txt	BraveNewWorld.txt	PrideAndPrejudice.txt
work	BraveNewWorld.txt	TheWarOfTheWorlds.txt	Misery.txt	CrimeAndPunishment.txt	TheCitadel.txt	TheKingOfTorts.txt
workers	BraveNewWorld.txt	
working	TheKingOfTorts.txt	TheCitadel.txt	
worley	TheKingOfTorts.txt
wouldnt	TheKingOfTorts.txt	
writing	Misery.txt	
written	PrideAndPrejudice.txt	
year	CrimeAndPunishment.txt	PrideAndPrejudice.txt	TheKingOfTorts.txt	
yellow	CrimeAndPunishment.txt	
yes	BraveNewWorld.txt	TheCitadel.txt	PrideAndPrejudice.txt	TheKingOfTorts.txt	CrimeAndPunishment.txt	Misery.txt
youll	Misery.txt	TheKingOfTorts.txt	
young	BraveNewWorld.txt	PrideAndPrejudice.txt	Misery.txt	TheKingOfTorts.txt	TheCitadel.txt	CrimeAndPunishment.txt
younger	PrideAndPrejudice.txt	
youve	BraveNewWorld.txt	Misery.txt
