abbey	TheCitadel.txt
able	TheCitadel.txt	BraveNewWorld.txt	PrideAndPrejudice.txt
accepted	PrideAndPrejudice.txt
ackerman	TheKingOfTorts.txt
admiration	PrideAndPrejudice.txt
admit	PrideAndPrejudice.txt	
ago	CrimeAndPunishment.txt	TheKingOfTorts.txt	
agreed	PrideAndPrejudice.txt	TheCitadel.txt	TheKingOfTorts.txt
agreement	PrideAndPrejudice.txt	
angrily	BraveNewWorld.txt	
angry	TheKingOfTorts.txt	TheCitadel.txt	PrideAndPrejudice.txt	Misery.txt	BraveNewWorld.txt
answered	PrideAndPrejudice.txt	TheCitadel.txt	CrimeAndPunishment.txt	BraveNewWorld.txt	
anxiety	PrideAndPrejudice.txt	
arm	TheCitadel.txt	BraveNewWorld.txt	
arrived	TheCitadel.txt	PrideAndPrejudice.txt
artificial	BraveNewWorld.txt	
asleep	CrimeAndPunishment.txt	
astonished	PrideAndPrejudice.txt	
aunt	PrideAndPrejudice.txt	
away	CrimeAndPunishment.txt	TheWarOfTheWorlds.txt	PrideAndPrejudice.txt	TheKingOfTorts.txt	BraveNewWorld.txt	TheCitadel.txt	Misery.txt
badly	TheCitadel.txt	
barn	Misery.txt
bear	PrideAndPrejudice.txt
bed	TheKingOfTorts.txt	TheCitadel.txt	Misery.txt	BraveNewWorld.txt
began	TheKingOfTorts.txt	BraveNewWorld.txt	TheWarOfTheWorlds.txt	CrimeAndPunishment.txt	Misery.txt	PrideAndPrejudice.txt	TheCitadel.txt
beginning	BraveNewWorld.txt	
bennett	TheKingOfTorts.txt
bent	Misery.txt
bernard	BraveNewWorld.txt
better	CrimeAndPunishment.txt	BraveNewWorld.txt	TheCitadel.txt	PrideAndPrejudice.txt	TheKingOfTorts.txt	TheWarOfTheWorlds.txt	Misery.txt
bingley	PrideAndPrejudice.txt
bingleys	PrideAndPrejudice.txt
black	BraveNewWorld.txt	TheWarOfTheWorlds.txt	TheKingOfTorts.txt	
books	Misery.txt	BraveNewWorld.txt	
bought	TheCitadel.txt	
box	BraveNewWorld.txt	Misery.txt	
bramwell	TheCitadel.txt
breakfast	PrideAndPrejudice.txt	
bright	BraveNewWorld.txt	TheWarOfTheWorlds.txt	
bring	Misery.txt	
brother	TheWarOfTheWorlds.txt	PrideAndPrejudice.txt
called	Misery.txt	BraveNewWorld.txt	PrideAndPrejudice.txt	TheKingOfTorts.txt	TheCitadel.txt	
carefully	BraveNewWorld.txt	
carriage	PrideAndPrejudice.txt	
carried	BraveNewWorld.txt	
cases	TheKingOfTorts.txt	TheCitadel.txt
certain	PrideAndPrejudice.txt	
challis	TheCitadel.txt
chance	TheWarOfTheWorlds.txt	
character	PrideAndPrejudice.txt	
chenkin	TheCitadel.txt
choice	PrideAndPrejudice.txt	
clay	TheKingOfTorts.txt
clearly	TheWarOfTheWorlds.txt	
clients	TheKingOfTorts.txt
closed	Misery.txt	
clothes	BraveNewWorld.txt	PrideAndPrejudice.txt	Misery.txt	
colonel	PrideAndPrejudice.txt
coming	PrideAndPrejudice.txt	BraveNewWorld.txt	Misery.txt	CrimeAndPunishment.txt	TheWarOfTheWorlds.txt
common	TheWarOfTheWorlds.txt	
conditioning	BraveNewWorld.txt
considered	PrideAndPrejudice.txt	
continued	TheCitadel.txt	PrideAndPrejudice.txt	
control	PrideAndPrejudice.txt	
conversation	PrideAndPrejudice.txt	
corner	CrimeAndPunishment.txt	
court	TheKingOfTorts.txt	
courtroom	TheKingOfTorts.txt	
cross	Misery.txt
crying	BraveNewWorld.txt	
cure	TheCitadel.txt	
cut	BraveNewWorld.txt	Misery.txt	
dancing	PrideAndPrejudice.txt	
danger	TheWarOfTheWorlds.txt
darcys	PrideAndPrejudice.txt
daughters	PrideAndPrejudice.txt
dead	BraveNewWorld.txt	Misery.txt	TheWarOfTheWorlds.txt
death	TheWarOfTheWorlds.txt	BraveNewWorld.txt
decided	PrideAndPrejudice.txt	TheKingOfTorts.txt	BraveNewWorld.txt	TheCitadel.txt	TheWarOfTheWorlds.txt	
deltas	BraveNewWorld.txt
denny	TheCitadel.txt
details	TheKingOfTorts.txt	
did	CrimeAndPunishment.txt	BraveNewWorld.txt	TheWarOfTheWorlds.txt	Misery.txt	TheCitadel.txt	TheKingOfTorts.txt	PrideAndPrejudice.txt
dinner	PrideAndPrejudice.txt	TheKingOfTorts.txt	TheCitadel.txt
doctors	TheCitadel.txt	
dont	BraveNewWorld.txt	TheCitadel.txt	TheKingOfTorts.txt	Misery.txt	TheWarOfTheWorlds.txt	CrimeAndPunishment.txt
doubt	PrideAndPrejudice.txt	
dounia	CrimeAndPunishment.txt
dream	CrimeAndPunishment.txt	
drink	CrimeAndPunishment.txt	TheKingOfTorts.txt	TheCitadel.txt	
drug	TheKingOfTorts.txt	Misery.txt
drunk	CrimeAndPunishment.txt	
dyloft	TheKingOfTorts.txt
elizabeths	PrideAndPrejudice.txt
end	TheKingOfTorts.txt	PrideAndPrejudice.txt	BraveNewWorld.txt	Misery.txt	TheCitadel.txt	CrimeAndPunishment.txt	TheWarOfTheWorlds.txt
epsilons	BraveNewWorld.txt
escape	TheWarOfTheWorlds.txt	Misery.txt
evidence	TheKingOfTorts.txt	
examined	TheCitadel.txt	
excellent	PrideAndPrejudice.txt
expect	PrideAndPrejudice.txt	
expensive	TheCitadel.txt
expressed	PrideAndPrejudice.txt	
expression	TheCitadel.txt	BraveNewWorld.txt	PrideAndPrejudice.txt	
father	CrimeAndPunishment.txt	PrideAndPrejudice.txt	BraveNewWorld.txt	
fees	TheKingOfTorts.txt
fell	TheWarOfTheWorlds.txt	CrimeAndPunishment.txt	BraveNewWorld.txt	Misery.txt
fever	TheCitadel.txt
fight	TheKingOfTorts.txt	
file	TheKingOfTorts.txt
floors	BraveNewWorld.txt	
fortune	PrideAndPrejudice.txt	
freddie	TheCitadel.txt
friends	TheKingOfTorts.txt	TheCitadel.txt	BraveNewWorld.txt	PrideAndPrejudice.txt
future	TheKingOfTorts.txt	
gadsby	TheCitadel.txt
garden	TheWarOfTheWorlds.txt	PrideAndPrejudice.txt	
gave	BraveNewWorld.txt	CrimeAndPunishment.txt	TheWarOfTheWorlds.txt	TheCitadel.txt	TheKingOfTorts.txt	Misery.txt	PrideAndPrejudice.txt
girls	BraveNewWorld.txt	PrideAndPrejudice.txt	
god	CrimeAndPunishment.txt	BraveNewWorld.txt	
gone	TheWarOfTheWorlds.txt	Misery.txt	PrideAndPrejudice.txt	BraveNewWorld.txt	CrimeAndPunishment.txt	TheKingOfTorts.txt	TheCitadel.txt
good	TheCitadel.txt	PrideAndPrejudice.txt	TheWarOfTheWorlds.txt	Misery.txt	TheKingOfTorts.txt	BraveNewWorld.txt	CrimeAndPunishment.txt
grew	TheWarOfTheWorlds.txt	BraveNewWorld.txt	
ground	BraveNewWorld.txt	TheWarOfTheWorlds.txt	Misery.txt	
group	BraveNewWorld.txt	
growing	TheWarOfTheWorlds.txt	
guess	TheKingOfTorts.txt	
guilty	TheKingOfTorts.txt	
guy	TheKingOfTorts.txt
hadnt	TheKingOfTorts.txt	
hamson	TheCitadel.txt
hanna	TheKingOfTorts.txt
happiness	PrideAndPrejudice.txt	BraveNewWorld.txt	
having	BraveNewWorld.txt	PrideAndPrejudice.txt	
hear	Misery.txt	CrimeAndPunishment.txt	PrideAndPrejudice.txt	
heavens	TheCitadel.txt	PrideAndPrejudice.txt
held	TheWarOfTheWorlds.txt	BraveNewWorld.txt	TheCitadel.txt	
helen	TheKingOfTorts.txt
help	BraveNewWorld.txt	CrimeAndPunishment.txt	PrideAndPrejudice.txt	TheKingOfTorts.txt	TheCitadel.txt
hes	TheKingOfTorts.txt	BraveNewWorld.txt	TheCitadel.txt	
high	BraveNewWorld.txt	TheWarOfTheWorlds.txt	
hill	TheWarOfTheWorlds.txt	
holiday	BraveNewWorld.txt	
home	TheWarOfTheWorlds.txt	CrimeAndPunishment.txt	TheCitadel.txt	TheKingOfTorts.txt	PrideAndPrejudice.txt
honour	PrideAndPrejudice.txt	
hope	TheWarOfTheWorlds.txt	PrideAndPrejudice.txt	TheCitadel.txt	
horse	TheWarOfTheWorlds.txt	
hospital	TheKingOfTorts.txt	Misery.txt	TheCitadel.txt
hour	PrideAndPrejudice.txt	TheCitadel.txt	TheKingOfTorts.txt	
house	Misery.txt	TheWarOfTheWorlds.txt	CrimeAndPunishment.txt	PrideAndPrejudice.txt	TheKingOfTorts.txt	TheCitadel.txt	BraveNewWorld.txt
huge	TheKingOfTorts.txt	
hullo	TheCitadel.txt
hurried	TheWarOfTheWorlds.txt	
hurst	PrideAndPrejudice.txt
important	TheCitadel.txt	TheKingOfTorts.txt	
impossible	PrideAndPrejudice.txt	
inquiry	TheCitadel.txt	
intention	PrideAndPrejudice.txt	
interested	TheKingOfTorts.txt	
invited	TheCitadel.txt	
isnt	TheCitadel.txt
ivory	TheCitadel.txt
jail	TheKingOfTorts.txt
jet	TheKingOfTorts.txt
john	BraveNewWorld.txt
judge	TheKingOfTorts.txt	
jury	TheKingOfTorts.txt	
kill	Misery.txt	
kilometres	TheWarOfTheWorlds.txt	
kind	TheCitadel.txt	PrideAndPrejudice.txt	CrimeAndPunishment.txt
kitchen	TheWarOfTheWorlds.txt	Misery.txt	
knew	CrimeAndPunishment.txt	TheCitadel.txt	TheKingOfTorts.txt	Misery.txt	TheWarOfTheWorlds.txt	PrideAndPrejudice.txt	BraveNewWorld.txt
known	PrideAndPrejudice.txt	TheKingOfTorts.txt	
landlady	CrimeAndPunishment.txt
late	TheKingOfTorts.txt	TheCitadel.txt	
later	TheWarOfTheWorlds.txt	TheCitadel.txt	CrimeAndPunishment.txt	TheKingOfTorts.txt	PrideAndPrejudice.txt	Misery.txt	BraveNewWorld.txt
laughed	BraveNewWorld.txt	TheCitadel.txt	
laughing	CrimeAndPunishment.txt	
lawyers	TheKingOfTorts.txt	
lay	BraveNewWorld.txt	TheWarOfTheWorlds.txt	CrimeAndPunishment.txt	
leaving	PrideAndPrejudice.txt	TheCitadel.txt
lenina	BraveNewWorld.txt
lets	TheKingOfTorts.txt
life	CrimeAndPunishment.txt	TheCitadel.txt	TheWarOfTheWorlds.txt	BraveNewWorld.txt	PrideAndPrejudice.txt	Misery.txt	TheKingOfTorts.txt
lift	BraveNewWorld.txt	
light	TheWarOfTheWorlds.txt	CrimeAndPunishment.txt	Misery.txt	BraveNewWorld.txt
lips	Misery.txt	
listen	TheCitadel.txt
listened	BraveNewWorld.txt	CrimeAndPunishment.txt	PrideAndPrejudice.txt	
living	TheCitadel.txt	TheWarOfTheWorlds.txt	
lizzy	PrideAndPrejudice.txt
lock	Misery.txt
look	BraveNewWorld.txt	TheKingOfTorts.txt	PrideAndPrejudice.txt	TheCitadel.txt	TheWarOfTheWorlds.txt	Misery.txt	CrimeAndPunishment.txt
lot	TheCitadel.txt	TheKingOfTorts.txt	Misery.txt	BraveNewWorld.txt	
lovely	TheCitadel.txt	
low	BraveNewWorld.txt	
lucas	PrideAndPrejudice.txt
lydias	PrideAndPrejudice.txt
machines	TheWarOfTheWorlds.txt
making	PrideAndPrejudice.txt	BraveNewWorld.txt	Misery.txt	
manners	PrideAndPrejudice.txt	
manson	TheCitadel.txt
marks	Misery.txt	
marriage	PrideAndPrejudice.txt	
marx	BraveNewWorld.txt
max	TheKingOfTorts.txt
maybury	TheWarOfTheWorlds.txt
medicine	TheCitadel.txt	Misery.txt
members	TheCitadel.txt	
men	TheKingOfTorts.txt	BraveNewWorld.txt	CrimeAndPunishment.txt	TheWarOfTheWorlds.txt	TheCitadel.txt
met	PrideAndPrejudice.txt	CrimeAndPunishment.txt	TheKingOfTorts.txt	TheCitadel.txt	
midnight	TheWarOfTheWorlds.txt	
mikolka	CrimeAndPunishment.txt
million	TheKingOfTorts.txt	
minute	TheCitadel.txt	CrimeAndPunishment.txt	
miserys	Misery.txt
mistake	TheKingOfTorts.txt	
morning	TheCitadel.txt	Misery.txt	TheWarOfTheWorlds.txt	BraveNewWorld.txt	PrideAndPrejudice.txt	TheKingOfTorts.txt
mother	CrimeAndPunishment.txt	PrideAndPrejudice.txt	BraveNewWorld.txt
mouth	Misery.txt	
moved	Misery.txt	TheWarOfTheWorlds.txt	PrideAndPrejudice.txt	TheKingOfTorts.txt	BraveNewWorld.txt
mrs	PrideAndPrejudice.txt	TheKingOfTorts.txt	TheCitadel.txt
music	BraveNewWorld.txt	
nature	PrideAndPrejudice.txt	
near	PrideAndPrejudice.txt	TheWarOfTheWorlds.txt	
needed	Misery.txt	
newspaper	TheKingOfTorts.txt	
nodded	BraveNewWorld.txt
noise	TheWarOfTheWorlds.txt	
novel	Misery.txt
number	TheWarOfTheWorlds.txt	TheKingOfTorts.txt	
nurse	BraveNewWorld.txt	TheCitadel.txt
object	PrideAndPrejudice.txt	
odd	BraveNewWorld.txt	
offer	TheKingOfTorts.txt	PrideAndPrejudice.txt	
officers	PrideAndPrejudice.txt	
oh	TheCitadel.txt	BraveNewWorld.txt	CrimeAndPunishment.txt	Misery.txt	PrideAndPrejudice.txt
ok	TheKingOfTorts.txt	
ones	TheWarOfTheWorlds.txt	BraveNewWorld.txt	CrimeAndPunishment.txt
opd	TheKingOfTorts.txt
open	CrimeAndPunishment.txt	TheWarOfTheWorlds.txt	Misery.txt	BraveNewWorld.txt
opening	TheWarOfTheWorlds.txt	
opinion	PrideAndPrejudice.txt
opportunity	PrideAndPrejudice.txt	
oscar	TheKingOfTorts.txt
ought	TheCitadel.txt	PrideAndPrejudice.txt	BraveNewWorld.txt
paces	CrimeAndPunishment.txt	
page	TheCitadel.txt	
paper	Misery.txt	
party	PrideAndPrejudice.txt
passed	CrimeAndPunishment.txt	PrideAndPrejudice.txt	BraveNewWorld.txt	TheWarOfTheWorlds.txt	
past	CrimeAndPunishment.txt	TheWarOfTheWorlds.txt
paul	Misery.txt
paulette	TheKingOfTorts.txt
pause	PrideAndPrejudice.txt	
pemberley	PrideAndPrejudice.txt
philip	TheCitadel.txt
plaintiffs	TheKingOfTorts.txt
pleased	PrideAndPrejudice.txt	TheCitadel.txt
pleasing	PrideAndPrejudice.txt
pledge	CrimeAndPunishment.txt
pocket	CrimeAndPunishment.txt	
point	BraveNewWorld.txt	CrimeAndPunishment.txt	
pointed	BraveNewWorld.txt	
policeman	CrimeAndPunishment.txt	Misery.txt
possible	TheKingOfTorts.txt	CrimeAndPunishment.txt	PrideAndPrejudice.txt	
practice	TheCitadel.txt
prevented	PrideAndPrejudice.txt	
proud	PrideAndPrejudice.txt	
pulled	BraveNewWorld.txt	Misery.txt	
pushed	Misery.txt	BraveNewWorld.txt	TheWarOfTheWorlds.txt	
quietly	TheKingOfTorts.txt	
radio	BraveNewWorld.txt	
ready	PrideAndPrejudice.txt	CrimeAndPunishment.txt	TheKingOfTorts.txt	
really	Misery.txt	TheCitadel.txt	BraveNewWorld.txt	TheKingOfTorts.txt	CrimeAndPunishment.txt	PrideAndPrejudice.txt
rebecca	TheKingOfTorts.txt
receive	PrideAndPrejudice.txt	
redding	TheKingOfTorts.txt
regiment	PrideAndPrejudice.txt
remember	CrimeAndPunishment.txt	Misery.txt	BraveNewWorld.txt	TheWarOfTheWorlds.txt	
remembered	PrideAndPrejudice.txt	Misery.txt	BraveNewWorld.txt
rest	TheKingOfTorts.txt	TheCitadel.txt	PrideAndPrejudice.txt	
returned	TheCitadel.txt	TheWarOfTheWorlds.txt	PrideAndPrejudice.txt
rich	TheKingOfTorts.txt	TheCitadel.txt
ridley	TheKingOfTorts.txt
right	TheKingOfTorts.txt	TheWarOfTheWorlds.txt	CrimeAndPunishment.txt	BraveNewWorld.txt	Misery.txt	PrideAndPrejudice.txt	TheCitadel.txt
road	TheWarOfTheWorlds.txt	Misery.txt	
rooms	BraveNewWorld.txt	
running	TheWarOfTheWorlds.txt	
satisfied	PrideAndPrejudice.txt
savage	BraveNewWorld.txt
science	BraveNewWorld.txt	
secret	TheKingOfTorts.txt	
sense	PrideAndPrejudice.txt	
set	PrideAndPrejudice.txt	BraveNewWorld.txt	
settled	PrideAndPrejudice.txt	
settlement	TheKingOfTorts.txt
seven	TheKingOfTorts.txt	CrimeAndPunishment.txt	
shares	TheKingOfTorts.txt
sharp	TheCitadel.txt	
ships	TheWarOfTheWorlds.txt
shook	BraveNewWorld.txt
short	PrideAndPrejudice.txt	
shut	Misery.txt	BraveNewWorld.txt	
silence	TheCitadel.txt	BraveNewWorld.txt	TheWarOfTheWorlds.txt	PrideAndPrejudice.txt	
silent	BraveNewWorld.txt	TheWarOfTheWorlds.txt	
simply	CrimeAndPunishment.txt	
singing	BraveNewWorld.txt	
sisters	PrideAndPrejudice.txt	
situation	PrideAndPrejudice.txt	
slowly	BraveNewWorld.txt	TheWarOfTheWorlds.txt	TheCitadel.txt	TheKingOfTorts.txt	
snow	Misery.txt
sofa	CrimeAndPunishment.txt	
soldier	TheWarOfTheWorlds.txt
soldiers	TheWarOfTheWorlds.txt	
sorry	PrideAndPrejudice.txt	TheCitadel.txt	TheKingOfTorts.txt	
space	TheWarOfTheWorlds.txt	
spent	TheKingOfTorts.txt	PrideAndPrejudice.txt	
stared	BraveNewWorld.txt
staring	BraveNewWorld.txt	
state	PrideAndPrejudice.txt	
stay	Misery.txt	TheWarOfTheWorlds.txt	PrideAndPrejudice.txt	TheCitadel.txt
stepped	BraveNewWorld.txt	
straight	CrimeAndPunishment.txt	Misery.txt	TheCitadel.txt
streets	TheWarOfTheWorlds.txt	
student	CrimeAndPunishment.txt	
students	BraveNewWorld.txt
sudden	BraveNewWorld.txt	CrimeAndPunishment.txt	
suddenly	TheCitadel.txt	PrideAndPrejudice.txt	Misery.txt	TheWarOfTheWorlds.txt	BraveNewWorld.txt	CrimeAndPunishment.txt
surface	TheWarOfTheWorlds.txt	
surprise	BraveNewWorld.txt	TheCitadel.txt	PrideAndPrejudice.txt	
talk	TheKingOfTorts.txt	TheCitadel.txt	PrideAndPrejudice.txt	
tea	CrimeAndPunishment.txt	
ted	TheKingOfTorts.txt
telephone	TheCitadel.txt
telephoned	TheCitadel.txt	
terrible	TheWarOfTheWorlds.txt	
thames	TheWarOfTheWorlds.txt
thats	TheWarOfTheWorlds.txt	CrimeAndPunishment.txt	Misery.txt	TheKingOfTorts.txt	TheCitadel.txt	BraveNewWorld.txt
theres	CrimeAndPunishment.txt	BraveNewWorld.txt	TheCitadel.txt	TheKingOfTorts.txt
theyre	TheKingOfTorts.txt	BraveNewWorld.txt	
think	CrimeAndPunishment.txt	TheCitadel.txt	PrideAndPrejudice.txt	TheKingOfTorts.txt	TheWarOfTheWorlds.txt	BraveNewWorld.txt	Misery.txt
thoroughgood	TheCitadel.txt
thought	TheCitadel.txt	PrideAndPrejudice.txt	CrimeAndPunishment.txt	Misery.txt	TheKingOfTorts.txt	BraveNewWorld.txt	TheWarOfTheWorlds.txt
threw	BraveNewWorld.txt	Misery.txt
thunder	TheWarOfTheWorlds.txt	
till	CrimeAndPunishment.txt	
time	TheCitadel.txt	BraveNewWorld.txt	TheKingOfTorts.txt	Misery.txt	CrimeAndPunishment.txt	PrideAndPrejudice.txt	TheWarOfTheWorlds.txt
tired	TheCitadel.txt	TheWarOfTheWorlds.txt	BraveNewWorld.txt	
train	TheWarOfTheWorlds.txt	TheCitadel.txt
tried	TheCitadel.txt	CrimeAndPunishment.txt	Misery.txt	PrideAndPrejudice.txt	BraveNewWorld.txt	TheWarOfTheWorlds.txt	TheKingOfTorts.txt
trouble	TheCitadel.txt	TheKingOfTorts.txt	
trying	TheKingOfTorts.txt	TheCitadel.txt	CrimeAndPunishment.txt	TheWarOfTheWorlds.txt	
typewriter	Misery.txt
ugly	BraveNewWorld.txt	
usual	PrideAndPrejudice.txt	
village	BraveNewWorld.txt	
wait	CrimeAndPunishment.txt	
waiting	BraveNewWorld.txt	TheKingOfTorts.txt	TheCitadel.txt	
walk	PrideAndPrejudice.txt
walking	PrideAndPrejudice.txt	TheWarOfTheWorlds.txt	CrimeAndPunishment.txt	TheCitadel.txt
wasnt	TheKingOfTorts.txt	BraveNewWorld.txt	Misery.txt
watching	TheWarOfTheWorlds.txt	TheKingOfTorts.txt	
week	TheKingOfTorts.txt	PrideAndPrejudice.txt	TheCitadel.txt	
went	PrideAndPrejudice.txt	BraveNewWorld.txt	TheCitadel.txt	Misery.txt	CrimeAndPunishment.txt	TheWarOfTheWorlds.txt	TheKingOfTorts.txt
whats	TheCitadel.txt	
wheelchair	Misery.txt	
whip	BraveNewWorld.txt	
whispered	BraveNewWorld.txt	
white	BraveNewWorld.txt	TheWarOfTheWorlds.txt	
wickham	PrideAndPrejudice.txt
wish	PrideAndPrejudice.txt	TheCitadel.txt	
wonderful	BraveNewWorld.txt	
worried	TheCitadel.txt	TheKingOfTorts.txt	
worse	TheCitadel.txt	
wrong	TheCitadel.txt	TheKingOfTorts.txt
years	Misery.txt	TheKingOfTorts.txt	CrimeAndPunishment.txt	TheCitadel.txt
