action	TheKingOfTorts.txt	
added	PrideAndPrejudice.txt	TheCitadel.txt	BraveNewWorld.txt
adelfa	TheKingOfTorts.txt
advice	TheCitadel.txt	
allow	PrideAndPrejudice.txt	
allowed	PrideAndPrejudice.txt	
alyona	CrimeAndPunishment.txt
andrew	TheCitadel.txt	
andrews	TheCitadel.txt
anger	TheCitadel.txt	PrideAndPrejudice.txt	BraveNewWorld.txt
animal	BraveNewWorld.txt	
annies	Misery.txt
annoyed	TheCitadel.txt	
answer	PrideAndPrejudice.txt	BraveNewWorld.txt	TheCitadel.txt	CrimeAndPunishment.txt	
arms	BraveNewWorld.txt	
arrival	PrideAndPrejudice.txt	
ashamed	BraveNewWorld.txt	PrideAndPrejudice.txt
awful	BraveNewWorld.txt
axe	Misery.txt	CrimeAndPunishment.txt
babies	BraveNewWorld.txt
baby	TheCitadel.txt	
ball	PrideAndPrejudice.txt	
bar	TheKingOfTorts.txt	
beauty	PrideAndPrejudice.txt	
believe	TheCitadel.txt	Misery.txt	TheKingOfTorts.txt	PrideAndPrejudice.txt
big	TheKingOfTorts.txt	CrimeAndPunishment.txt	BraveNewWorld.txt	TheWarOfTheWorlds.txt	Misery.txt
bird	Misery.txt	
blame	PrideAndPrejudice.txt	CrimeAndPunishment.txt	
blood	BraveNewWorld.txt	Misery.txt	CrimeAndPunishment.txt	
bottle	TheCitadel.txt	BraveNewWorld.txt
bottles	BraveNewWorld.txt	
bourgh	PrideAndPrejudice.txt
boy	BraveNewWorld.txt	TheKingOfTorts.txt
bread	TheWarOfTheWorlds.txt	
brighton	PrideAndPrejudice.txt
broke	BraveNewWorld.txt	
broken	Misery.txt	CrimeAndPunishment.txt	TheWarOfTheWorlds.txt	
brown	BraveNewWorld.txt	
burnt	TheWarOfTheWorlds.txt	
bushes	TheWarOfTheWorlds.txt	
buy	TheCitadel.txt
camp	TheKingOfTorts.txt	
cancer	TheKingOfTorts.txt
care	PrideAndPrejudice.txt	TheCitadel.txt	
cart	TheWarOfTheWorlds.txt	CrimeAndPunishment.txt
carter	TheKingOfTorts.txt
caused	PrideAndPrejudice.txt
centre	BraveNewWorld.txt	
chair	Misery.txt	TheCitadel.txt
change	TheCitadel.txt	PrideAndPrejudice.txt	
chapter	TheKingOfTorts.txt	TheCitadel.txt	Misery.txt	BraveNewWorld.txt	TheWarOfTheWorlds.txt	PrideAndPrejudice.txt
charlotte	PrideAndPrejudice.txt
cheque	TheCitadel.txt
chertsey	TheWarOfTheWorlds.txt
child	TheCitadel.txt	Misery.txt	
children	BraveNewWorld.txt	Misery.txt	CrimeAndPunishment.txt	PrideAndPrejudice.txt	
chris	TheCitadel.txt
christmas	TheCitadel.txt	
city	TheWarOfTheWorlds.txt	TheKingOfTorts.txt	
class	TheKingOfTorts.txt	
clays	TheKingOfTorts.txt
clear	CrimeAndPunishment.txt	TheWarOfTheWorlds.txt	
clever	TheCitadel.txt	
close	TheWarOfTheWorlds.txt	Misery.txt	CrimeAndPunishment.txt	TheKingOfTorts.txt	
clouds	TheWarOfTheWorlds.txt
coat	CrimeAndPunishment.txt	
collinss	PrideAndPrejudice.txt
come	CrimeAndPunishment.txt	TheKingOfTorts.txt	BraveNewWorld.txt	TheCitadel.txt	PrideAndPrejudice.txt	Misery.txt	TheWarOfTheWorlds.txt
committee	TheCitadel.txt
companion	PrideAndPrejudice.txt	
completely	TheWarOfTheWorlds.txt	CrimeAndPunishment.txt	PrideAndPrejudice.txt
contract	TheKingOfTorts.txt
controller	BraveNewWorld.txt
council	TheCitadel.txt	
country	TheKingOfTorts.txt	TheWarOfTheWorlds.txt	TheCitadel.txt
creatures	TheWarOfTheWorlds.txt	
cried	BraveNewWorld.txt	PrideAndPrejudice.txt	CrimeAndPunishment.txt	TheCitadel.txt
crowd	CrimeAndPunishment.txt	TheWarOfTheWorlds.txt	BraveNewWorld.txt	
curate	TheWarOfTheWorlds.txt
cylinder	TheWarOfTheWorlds.txt
dance	PrideAndPrejudice.txt	
dangerous	TheKingOfTorts.txt	
darcy	PrideAndPrejudice.txt
dawn	TheWarOfTheWorlds.txt
day	TheWarOfTheWorlds.txt	BraveNewWorld.txt	CrimeAndPunishment.txt	TheKingOfTorts.txt	Misery.txt	PrideAndPrejudice.txt	TheCitadel.txt
deep	TheCitadel.txt	BraveNewWorld.txt
degree	TheCitadel.txt
desk	TheKingOfTorts.txt	
didnt	TheKingOfTorts.txt	Misery.txt	BraveNewWorld.txt	TheCitadel.txt
die	Misery.txt	
director	BraveNewWorld.txt
disease	TheCitadel.txt	
doesnt	BraveNewWorld.txt	TheCitadel.txt
dragon	Misery.txt
dressed	CrimeAndPunishment.txt	
drugs	TheKingOfTorts.txt	
drums	BraveNewWorld.txt	
earlier	TheKingOfTorts.txt	
edge	TheWarOfTheWorlds.txt	
embryos	BraveNewWorld.txt
emlyn	TheCitadel.txt
evening	TheCitadel.txt	PrideAndPrejudice.txt	TheWarOfTheWorlds.txt	
examination	TheCitadel.txt
excitedly	TheCitadel.txt	
expected	PrideAndPrejudice.txt	
extremely	PrideAndPrejudice.txt	
eyes	CrimeAndPunishment.txt	BraveNewWorld.txt	TheKingOfTorts.txt	Misery.txt	TheCitadel.txt	TheWarOfTheWorlds.txt	PrideAndPrejudice.txt
face	TheKingOfTorts.txt	PrideAndPrejudice.txt	CrimeAndPunishment.txt	BraveNewWorld.txt	TheWarOfTheWorlds.txt	Misery.txt	TheCitadel.txt
fact	PrideAndPrejudice.txt	
fallen	TheWarOfTheWorlds.txt	
falling	TheWarOfTheWorlds.txt	
fanny	BraveNewWorld.txt
fear	TheWarOfTheWorlds.txt	Misery.txt	BraveNewWorld.txt	
feeling	PrideAndPrejudice.txt	TheCitadel.txt	BraveNewWorld.txt	CrimeAndPunishment.txt
feelings	PrideAndPrejudice.txt	
feet	TheWarOfTheWorlds.txt	BraveNewWorld.txt
filed	TheKingOfTorts.txt
finally	TheKingOfTorts.txt	
finish	Misery.txt	
fired	TheWarOfTheWorlds.txt
flat	CrimeAndPunishment.txt	
floor	Misery.txt	CrimeAndPunishment.txt	BraveNewWorld.txt	
fool	TheCitadel.txt	
forward	TheCitadel.txt	BraveNewWorld.txt
foster	BraveNewWorld.txt
frequently	PrideAndPrejudice.txt	
friend	TheKingOfTorts.txt	TheCitadel.txt	BraveNewWorld.txt	PrideAndPrejudice.txt	
friendly	TheCitadel.txt	PrideAndPrejudice.txt
frightened	Misery.txt	TheWarOfTheWorlds.txt	
furniture	TheCitadel.txt	
gentleman	PrideAndPrejudice.txt	
getting	TheKingOfTorts.txt	Misery.txt	TheWarOfTheWorlds.txt	
given	CrimeAndPunishment.txt	TheCitadel.txt	PrideAndPrejudice.txt	
glad	PrideAndPrejudice.txt	
got	CrimeAndPunishment.txt	TheCitadel.txt	BraveNewWorld.txt	TheWarOfTheWorlds.txt	Misery.txt	TheKingOfTorts.txt
great	TheKingOfTorts.txt	CrimeAndPunishment.txt	BraveNewWorld.txt	TheWarOfTheWorlds.txt	PrideAndPrejudice.txt	TheCitadel.txt	
gun	TheKingOfTorts.txt	Misery.txt	TheWarOfTheWorlds.txt
hair	CrimeAndPunishment.txt	BraveNewWorld.txt	Misery.txt	
half	CrimeAndPunishment.txt	BraveNewWorld.txt	PrideAndPrejudice.txt	TheCitadel.txt
hall	TheCitadel.txt	Misery.txt	TheWarOfTheWorlds.txt	
hand	TheWarOfTheWorlds.txt	CrimeAndPunishment.txt	Misery.txt	PrideAndPrejudice.txt	TheCitadel.txt	TheKingOfTorts.txt	BraveNewWorld.txt
happy	TheCitadel.txt	PrideAndPrejudice.txt	BraveNewWorld.txt	TheKingOfTorts.txt
hardly	TheWarOfTheWorlds.txt	PrideAndPrejudice.txt	
head	CrimeAndPunishment.txt	TheCitadel.txt	TheWarOfTheWorlds.txt	Misery.txt	TheKingOfTorts.txt	PrideAndPrejudice.txt	BraveNewWorld.txt
heard	CrimeAndPunishment.txt	TheKingOfTorts.txt	TheWarOfTheWorlds.txt	Misery.txt	BraveNewWorld.txt	PrideAndPrejudice.txt	TheCitadel.txt
heatray	TheWarOfTheWorlds.txt
helicopter	BraveNewWorld.txt
hid	TheWarOfTheWorlds.txt
himself	TheCitadel.txt	Misery.txt	CrimeAndPunishment.txt	TheKingOfTorts.txt	BraveNewWorld.txt	PrideAndPrejudice.txt
hopes	PrideAndPrejudice.txt	
horror	BraveNewWorld.txt	
hotel	TheCitadel.txt	TheKingOfTorts.txt	
hours	TheWarOfTheWorlds.txt	TheKingOfTorts.txt	BraveNewWorld.txt	Misery.txt
human	BraveNewWorld.txt	TheWarOfTheWorlds.txt	
husband	PrideAndPrejudice.txt	TheKingOfTorts.txt	CrimeAndPunishment.txt
ill	Misery.txt	TheKingOfTorts.txt	CrimeAndPunishment.txt	TheCitadel.txt	BraveNewWorld.txt	
information	PrideAndPrejudice.txt	TheKingOfTorts.txt	
instead	BraveNewWorld.txt	PrideAndPrejudice.txt	
intently	CrimeAndPunishment.txt
ivanovna	CrimeAndPunishment.txt
ive	CrimeAndPunishment.txt	TheCitadel.txt	BraveNewWorld.txt	Misery.txt	TheKingOfTorts.txt
jane	PrideAndPrejudice.txt
job	TheKingOfTorts.txt	
joe	TheCitadel.txt
joel	TheKingOfTorts.txt
jonah	TheKingOfTorts.txt
killed	TheKingOfTorts.txt	Misery.txt	TheWarOfTheWorlds.txt	
knife	Misery.txt	
know	BraveNewWorld.txt	CrimeAndPunishment.txt	PrideAndPrejudice.txt	TheCitadel.txt	TheWarOfTheWorlds.txt	Misery.txt	TheKingOfTorts.txt
lack	PrideAndPrejudice.txt	
ladies	PrideAndPrejudice.txt
lady	PrideAndPrejudice.txt	Misery.txt	
laughter	CrimeAndPunishment.txt	
law	TheKingOfTorts.txt	
lawnmower	Misery.txt
learned	TheWarOfTheWorlds.txt
leatherhead	TheWarOfTheWorlds.txt
leave	TheWarOfTheWorlds.txt	TheKingOfTorts.txt	Misery.txt	PrideAndPrejudice.txt	TheCitadel.txt	
led	TheCitadel.txt	
leg	Misery.txt	
leninas	BraveNewWorld.txt
letter	CrimeAndPunishment.txt	PrideAndPrejudice.txt	TheCitadel.txt	
lifted	BraveNewWorld.txt	
likely	PrideAndPrejudice.txt	
list	TheKingOfTorts.txt	
litigation	TheKingOfTorts.txt	
live	CrimeAndPunishment.txt	TheWarOfTheWorlds.txt
london	TheWarOfTheWorlds.txt	BraveNewWorld.txt	TheCitadel.txt	PrideAndPrejudice.txt	
long	BraveNewWorld.txt	TheCitadel.txt	Misery.txt	CrimeAndPunishment.txt	TheWarOfTheWorlds.txt	TheKingOfTorts.txt	PrideAndPrejudice.txt
longer	PrideAndPrejudice.txt	
looked	TheKingOfTorts.txt	BraveNewWorld.txt	PrideAndPrejudice.txt	TheWarOfTheWorlds.txt	Misery.txt	TheCitadel.txt	CrimeAndPunishment.txt
looking	CrimeAndPunishment.txt	PrideAndPrejudice.txt	TheKingOfTorts.txt	BraveNewWorld.txt	TheCitadel.txt	TheWarOfTheWorlds.txt	Misery.txt
lose	TheKingOfTorts.txt
lost	TheCitadel.txt	BraveNewWorld.txt	TheKingOfTorts.txt	CrimeAndPunishment.txt	
loudly	BraveNewWorld.txt
love	CrimeAndPunishment.txt	PrideAndPrejudice.txt	TheCitadel.txt	TheKingOfTorts.txt	Misery.txt	BraveNewWorld.txt
lydia	PrideAndPrejudice.txt
mad	BraveNewWorld.txt	
make	BraveNewWorld.txt	Misery.txt	PrideAndPrejudice.txt	CrimeAndPunishment.txt	TheKingOfTorts.txt	TheCitadel.txt
manner	PrideAndPrejudice.txt	TheCitadel.txt
marfa	CrimeAndPunishment.txt
market	CrimeAndPunishment.txt	
marmeladov	CrimeAndPunishment.txt
marry	PrideAndPrejudice.txt	
mars	TheWarOfTheWorlds.txt
martian	TheWarOfTheWorlds.txt
mary	TheCitadel.txt	PrideAndPrejudice.txt
matter	PrideAndPrejudice.txt	CrimeAndPunishment.txt	TheCitadel.txt	
mattress	Misery.txt
mean	PrideAndPrejudice.txt	BraveNewWorld.txt	TheCitadel.txt	
meeting	TheKingOfTorts.txt	TheCitadel.txt	
mentioned	PrideAndPrejudice.txt	
metal	TheWarOfTheWorlds.txt	
metres	TheWarOfTheWorlds.txt
mines	TheCitadel.txt
misery	Misery.txt
miss	PrideAndPrejudice.txt	TheCitadel.txt
moment	BraveNewWorld.txt	CrimeAndPunishment.txt	Misery.txt	TheKingOfTorts.txt	TheCitadel.txt	TheWarOfTheWorlds.txt	PrideAndPrejudice.txt
money	CrimeAndPunishment.txt	PrideAndPrejudice.txt	TheKingOfTorts.txt	TheCitadel.txt
months	PrideAndPrejudice.txt	TheKingOfTorts.txt	
mooneyham	TheKingOfTorts.txt
moving	TheWarOfTheWorlds.txt	
myself	TheWarOfTheWorlds.txt	CrimeAndPunishment.txt	PrideAndPrejudice.txt	
nephew	PrideAndPrejudice.txt
netherfield	PrideAndPrejudice.txt
new	TheKingOfTorts.txt	BraveNewWorld.txt	PrideAndPrejudice.txt	Misery.txt	TheCitadel.txt
niece	PrideAndPrejudice.txt
north	TheWarOfTheWorlds.txt	
note	TheCitadel.txt	
noticed	CrimeAndPunishment.txt	TheWarOfTheWorlds.txt	
oclock	CrimeAndPunishment.txt	TheCitadel.txt	TheWarOfTheWorlds.txt	
office	TheCitadel.txt	TheKingOfTorts.txt	
official	BraveNewWorld.txt	
opened	Misery.txt	PrideAndPrejudice.txt	BraveNewWorld.txt	CrimeAndPunishment.txt	TheCitadel.txt
operation	TheCitadel.txt	
ordered	TheCitadel.txt	
outside	TheWarOfTheWorlds.txt	BraveNewWorld.txt	Misery.txt	
owen	TheCitadel.txt
pages	TheCitadel.txt	Misery.txt	
parents	TheKingOfTorts.txt
patients	TheCitadel.txt	
patton	TheKingOfTorts.txt
pauls	Misery.txt
pay	TheCitadel.txt	TheKingOfTorts.txt	
percent	TheKingOfTorts.txt
petersburg	CrimeAndPunishment.txt
petrovna	CrimeAndPunishment.txt
pit	TheWarOfTheWorlds.txt
planet	TheWarOfTheWorlds.txt
play	PrideAndPrejudice.txt
policemans	Misery.txt
pounds	TheCitadel.txt	PrideAndPrejudice.txt
president	TheCitadel.txt	
probably	TheKingOfTorts.txt	
problem	TheKingOfTorts.txt	
problems	TheKingOfTorts.txt	
property	PrideAndPrejudice.txt	
questions	TheKingOfTorts.txt	
quickly	TheWarOfTheWorlds.txt	BraveNewWorld.txt	TheCitadel.txt	Misery.txt	TheKingOfTorts.txt	
quiet	TheCitadel.txt	
quite	BraveNewWorld.txt	TheCitadel.txt	TheWarOfTheWorlds.txt	PrideAndPrejudice.txt	CrimeAndPunishment.txt	
rags	CrimeAndPunishment.txt
railway	TheWarOfTheWorlds.txt
ran	PrideAndPrejudice.txt	CrimeAndPunishment.txt	TheWarOfTheWorlds.txt	TheCitadel.txt	BraveNewWorld.txt
raskolnikov	CrimeAndPunishment.txt
rat	Misery.txt
razumihin	CrimeAndPunishment.txt
reached	CrimeAndPunishment.txt	PrideAndPrejudice.txt	TheCitadel.txt	Misery.txt	
real	PrideAndPrejudice.txt	BraveNewWorld.txt	Misery.txt	
realized	TheWarOfTheWorlds.txt	TheCitadel.txt	Misery.txt
received	PrideAndPrejudice.txt	TheCitadel.txt
receiving	PrideAndPrejudice.txt	
red	CrimeAndPunishment.txt	BraveNewWorld.txt	TheWarOfTheWorlds.txt	
relations	PrideAndPrejudice.txt
repeated	BraveNewWorld.txt	PrideAndPrejudice.txt
report	TheCitadel.txt	
respect	PrideAndPrejudice.txt	
river	TheWarOfTheWorlds.txt	
rodya	CrimeAndPunishment.txt
roof	BraveNewWorld.txt	
rose	BraveNewWorld.txt	TheWarOfTheWorlds.txt	TheCitadel.txt
rosings	PrideAndPrejudice.txt
roubles	CrimeAndPunishment.txt
round	TheCitadel.txt	CrimeAndPunishment.txt	Misery.txt	TheWarOfTheWorlds.txt	BraveNewWorld.txt
said	Misery.txt	TheWarOfTheWorlds.txt	BraveNewWorld.txt	TheCitadel.txt	TheKingOfTorts.txt	PrideAndPrejudice.txt	CrimeAndPunishment.txt
sank	CrimeAndPunishment.txt	
savages	BraveNewWorld.txt
say	TheKingOfTorts.txt	Misery.txt	BraveNewWorld.txt	CrimeAndPunishment.txt	TheCitadel.txt	PrideAndPrejudice.txt
scream	Misery.txt	
screamed	BraveNewWorld.txt	Misery.txt	
seat	CrimeAndPunishment.txt	
seeing	CrimeAndPunishment.txt	PrideAndPrejudice.txt	
send	CrimeAndPunishment.txt	PrideAndPrejudice.txt	TheCitadel.txt
services	TheCitadel.txt	
sheldon	Misery.txt
shining	TheWarOfTheWorlds.txt	
shouted	BraveNewWorld.txt	Misery.txt	TheWarOfTheWorlds.txt	CrimeAndPunishment.txt	TheCitadel.txt
showed	TheCitadel.txt	PrideAndPrejudice.txt	BraveNewWorld.txt	
sick	TheCitadel.txt	
sight	BraveNewWorld.txt	PrideAndPrejudice.txt	TheWarOfTheWorlds.txt
sitting	TheKingOfTorts.txt	Misery.txt	CrimeAndPunishment.txt	PrideAndPrejudice.txt
small	TheWarOfTheWorlds.txt	TheCitadel.txt	PrideAndPrejudice.txt	Misery.txt	TheKingOfTorts.txt	BraveNewWorld.txt
smiled	TheCitadel.txt	BraveNewWorld.txt	TheKingOfTorts.txt	Misery.txt
smiling	TheCitadel.txt	BraveNewWorld.txt	
smoke	TheWarOfTheWorlds.txt	
social	BraveNewWorld.txt	
soft	BraveNewWorld.txt	
soma	BraveNewWorld.txt
son	TheKingOfTorts.txt	
soon	CrimeAndPunishment.txt	PrideAndPrejudice.txt	TheWarOfTheWorlds.txt	Misery.txt	TheKingOfTorts.txt	TheCitadel.txt	
sort	CrimeAndPunishment.txt	
sounds	Misery.txt	
spirits	PrideAndPrejudice.txt	
spite	BraveNewWorld.txt	CrimeAndPunishment.txt
spoke	PrideAndPrejudice.txt	TheCitadel.txt	
staircase	CrimeAndPunishment.txt
stairs	CrimeAndPunishment.txt	Misery.txt	
standing	BraveNewWorld.txt	CrimeAndPunishment.txt	TheWarOfTheWorlds.txt	
start	Misery.txt	TheKingOfTorts.txt	
station	TheWarOfTheWorlds.txt	
stayed	TheWarOfTheWorlds.txt
stillman	TheCitadel.txt
stopped	Misery.txt	TheWarOfTheWorlds.txt	BraveNewWorld.txt	TheCitadel.txt	CrimeAndPunishment.txt	
struck	CrimeAndPunishment.txt	
stupid	Misery.txt	BraveNewWorld.txt	
subject	PrideAndPrejudice.txt	
success	TheCitadel.txt	PrideAndPrejudice.txt	
sun	TheWarOfTheWorlds.txt	
sure	PrideAndPrejudice.txt	Misery.txt	CrimeAndPunishment.txt	TheKingOfTorts.txt
surgery	TheCitadel.txt
surprised	TheCitadel.txt	PrideAndPrejudice.txt	
sweet	BraveNewWorld.txt	
tablets	Misery.txt
taken	CrimeAndPunishment.txt	TheWarOfTheWorlds.txt	TheKingOfTorts.txt	BraveNewWorld.txt	PrideAndPrejudice.txt
tarvan	TheKingOfTorts.txt
tears	BraveNewWorld.txt	TheCitadel.txt	
tequila	TheKingOfTorts.txt
terror	TheWarOfTheWorlds.txt	
thank	PrideAndPrejudice.txt	TheCitadel.txt	
theyll	Misery.txt	
thinking	BraveNewWorld.txt	CrimeAndPunishment.txt	PrideAndPrejudice.txt	TheCitadel.txt	TheKingOfTorts.txt
thirty	CrimeAndPunishment.txt	TheKingOfTorts.txt	TheCitadel.txt	
times	Misery.txt	CrimeAndPunishment.txt	BraveNewWorld.txt	TheCitadel.txt	
told	Misery.txt	BraveNewWorld.txt	TheWarOfTheWorlds.txt	PrideAndPrejudice.txt	TheKingOfTorts.txt	TheCitadel.txt
tomorrow	BraveNewWorld.txt	
tone	BraveNewWorld.txt
tower	BraveNewWorld.txt	
town	Misery.txt	TheCitadel.txt	PrideAndPrejudice.txt	TheKingOfTorts.txt	CrimeAndPunishment.txt
trial	TheKingOfTorts.txt	
troubled	PrideAndPrejudice.txt
truth	TheKingOfTorts.txt	PrideAndPrejudice.txt	
try	TheCitadel.txt	Misery.txt	
tumors	TheKingOfTorts.txt
turned	CrimeAndPunishment.txt	PrideAndPrejudice.txt	TheWarOfTheWorlds.txt	TheKingOfTorts.txt	BraveNewWorld.txt	TheCitadel.txt	Misery.txt
turning	BraveNewWorld.txt
tv	TheKingOfTorts.txt
typescript	Misery.txt
unable	PrideAndPrejudice.txt	
upset	BraveNewWorld.txt	
use	TheCitadel.txt	BraveNewWorld.txt	
voice	Misery.txt	TheWarOfTheWorlds.txt	CrimeAndPunishment.txt	PrideAndPrejudice.txt	BraveNewWorld.txt	TheKingOfTorts.txt	TheCitadel.txt
voices	BraveNewWorld.txt
wall	Misery.txt	
wanted	TheWarOfTheWorlds.txt	BraveNewWorld.txt	Misery.txt	TheKingOfTorts.txt	TheCitadel.txt
warshaw	TheKingOfTorts.txt
wedding	TheKingOfTorts.txt	
weeks	TheCitadel.txt	BraveNewWorld.txt	Misery.txt	
weybridge	TheWarOfTheWorlds.txt
wilkes	Misery.txt
window	TheWarOfTheWorlds.txt	Misery.txt	
woke	Misery.txt	
woking	TheWarOfTheWorlds.txt
woman	Misery.txt	CrimeAndPunishment.txt	TheCitadel.txt	PrideAndPrejudice.txt	TheKingOfTorts.txt	BraveNewWorld.txt
wont	Misery.txt	CrimeAndPunishment.txt	TheCitadel.txt	TheKingOfTorts.txt	BraveNewWorld.txt
wood	TheWarOfTheWorlds.txt	CrimeAndPunishment.txt	
word	BraveNewWorld.txt	PrideAndPrejudice.txt	CrimeAndPunishment.txt	TheCitadel.txt
worked	TheCitadel.txt	
world	TheWarOfTheWorlds.txt	PrideAndPrejudice.txt	BraveNewWorld.txt	Misery.txt	
worry	TheCitadel.txt	
write	BraveNewWorld.txt	Misery.txt	PrideAndPrejudice.txt	
wrote	TheCitadel.txt	
x	TheKingOfTorts.txt
yesterday	CrimeAndPunishment.txt	
york	TheKingOfTorts.txt	
youre	Misery.txt	TheCitadel.txt	TheKingOfTorts.txt	BraveNewWorld.txt
